11111111111111111111111111111
1P000001000000000000000101001
11100101111110000111001000001
1011110100001000000110010N001
10000001000011100100010001101
10111100010000001000011100001
10100010011111010001000100011
10110000000000001001000101001
10000011111110110100111010001
1C101000000000000001110001111
1011111100010001000E110000001
11111111111111111111111111111