1111111
1P00001
1000CE1
1111111